1111 1   1
1100000001
1100000001
1110011111
