11111111
10000001111
100000011
10000001
1111111
