SO ./assets/textures/mossy.xpm
NO ./assets/textures/mossy.xpm
WE ./assets/textures/mossy.xpm
EA ./assets/textures/mossy.xpm

F 10,10,10
C 100,100,100

11111
100N1
11101
11011
11111