11111111
10001
10001
1000111
1111111
