1011 1   1
1100000001
1100000001
1111111111
