
SO ./assets/textures/wall.xpm
NO ./assets/texturs/wall.xpm
WE ./assets/textures/bookshelf.xpm
EA ./assets/textures/bookshelf.xpm

F 105,85,52
C 237,233,218

1111111111111111111111111111111
1000000000000000000000000000001
1000000000001001000100000000001
1000000000010010010000000000001
1000000000000010110000000000001
1000000000001000101100000000001
1000000N00000011000000000000001
1000000000000011000000000000001
1000000000000011000000000000001
1000000000000011000000000000001
1000000000011111111000000000001
1000000000111111111100000000001
1000000000011100111000000000001
1000000000000000000000000000001
1000000000000000000000000000001
1111111111111111111111111111111