
SO ./assets/textures/wall.xpm
NO ./assets/textures/wall.xpm
WE ./assets/textures/bookshelf.xpm
EA ./assets/textures/bookshelf.xpm

F 105,85,52
C 237,233,218

1111111111111111111111111
1000000000110000000000001
1011000001110000000000001
1001000000000000000000001
111111111011000001110000011
100000000011000001110101011111111
11110111111111011000000010001
11110111111111011101010010001
11000000110101011100000000111
10000000000000   S00010001
10000000000000001101010010011
110000011101010111110111100111
11110111 1110101 101111010001
11111111 1111111 111111111111
